5 5 5 5 5 5 5 5 5 5 5 5 5 5 5 5 5 5 5 5 5 5 5 5 5 5 5 5 5 5 5 5 5 5 5 5 5 5 5 5 5 5 5 5 5 5 5 5 5 5 5
5 1 2 2 2 2 2 2 2 2 2 2 2 1 1 5 5 5 5 5 5 5 5 5 5 5 5 2 2 2 5 3 3 5 5 5 5 5 5 5 5 5 5 5 5 5 5 2 2 2 5
5 1 2 5 5 5 5 5 5 5 5 5 2 1 1 5 5 5 5 2 2 2 2 5 5 5 5 2 2 2 5 3 3 3 3 3 3 3 3 3 3 3 3 3 5 5 5 2 2 2 5
5 1 2 5 2 2 2 2 2 2 2 5 2 1 1 5 5 5 5 2 5 5 2 5 5 5 5 2 2 2 5 3 3 3 3 3 3 3 3 4 3 3 3 3 3 5 5 2 2 2 5
5 1 2 5 2 2 2 2 2 2 2 5 2 1 1 5 2 2 2 2 5 5 2 5 5 5 5 5 2 5 5 3 3 3 3 3 3 3 3 4 3 3 3 3 3 3 5 5 2 5 5
5 1 2 5 2 2 2 2 2 2 2 5 2 1 1 5 2 5 2 2 5 5 2 5 5 5 5 5 2 5 5 1 1 1 1 1 1 1 1 4 4 3 3 3 3 3 3 0 0 0 5
5 1 2 5 2 2 2 2 2 2 2 5 2 1 1 5 2 5 5 5 5 2 2 2 2 2 2 5 2 5 5 1 1 1 1 1 1 1 1 1 4 4 3 3 3 3 3 4 0 0 5
5 1 2 5 2 2 2 2 2 2 2 5 2 1 1 5 2 2 2 2 5 2 5 5 5 5 5 5 2 5 5 1 1 1 1 1 1 1 1 1 1 4 4 3 3 3 3 4 0 0 5
5 1 2 5 2 2 2 2 2 2 2 5 2 1 1 5 5 5 5 2 5 2 2 2 2 2 2 2 2 5 5 1 1 1 1 1 1 1 1 1 1 1 4 4 3 3 3 4 4 0 5
5 1 2 5 5 5 5 2 5 5 5 5 2 1 1 5 5 5 5 2 5 5 5 5 5 5 5 5 5 5 5 1 0 0 0 0 0 0 0 0 0 0 4 4 4 4 4 4 4 4 5
5 1 2 2 2 2 5 0 5 2 2 2 2 1 1 5 5 5 5 2 2 5 5 5 5 5 5 5 5 5 5 1 0 0 0 0 0 0 0 0 0 4 4 4 4 4 4 4 4 0 5
5 1 1 1 1 2 0 0 0 2 1 1 1 1 1 1 1 1 1 0 0 1 1 1 1 1 1 1 1 1 1 0 0 0 1 1 1 1 1 1 1 1 1 4 3 3 3 4 0 0 5
5 1 1 1 1 1 0 0 0 1 1 1 1 1 1 1 1 1 1 0 0 0 0 0 0 0 0 0 0 0 0 0 0 0 1 1 1 1 1 1 1 1 1 1 3 3 3 1 0 0 5
5 1 1 1 1 1 0 0 0 1 1 1 1 1 1 1 1 1 1 0 0 0 0 0 0 0 0 0 0 0 0 0 0 0 1 1 1 1 1 1 1 1 1 1 3 3 3 1 0 0 5
5 1 1 1 1 1 0 0 0 1 1 1 1 1 1 1 1 1 1 1 1 1 1 1 1 1 1 1 1 1 1 1 0 0 1 1 1 1 1 1 1 1 1 1 3 3 3 1 0 0 5
5 1 1 1 1 1 0 0 0 1 1 1 1 1 1 1 1 1 1 1 1 1 1 1 1 1 1 1 1 1 1 1 0 0 1 1 1 1 1 1 1 1 1 1 3 3 3 1 0 0 5
5 1 1 1 1 1 0 0 0 1 1 1 1 1 1 1 1 1 1 1 1 1 1 1 1 1 1 1 1 1 1 1 0 0 1 1 1 1 1 1 1 1 1 1 3 3 3 1 0 0 5
5 1 1 1 1 1 0 0 0 1 1 1 1 1 1 1 1 1 1 1 1 1 1 1 1 1 1 1 1 1 1 1 0 0 1 1 1 1 1 1 1 1 1 1 3 3 3 1 0 0 5
5 1 1 1 1 1 0 0 0 1 1 1 1 1 1 1 1 1 1 1 1 1 1 1 1 1 1 1 1 1 1 1 0 0 1 1 1 1 1 1 1 1 1 1 3 3 3 1 0 0 5
5 1 1 1 1 1 0 0 0 1 1 1 1 1 1 1 1 1 1 1 1 1 1 1 1 1 1 1 1 1 1 1 0 0 0 0 0 0 0 0 0 1 1 1 3 3 3 1 0 0 5
5 1 1 1 1 1 0 0 0 1 1 1 1 1 1 1 1 1 1 1 1 1 1 1 1 1 1 1 1 1 1 1 0 0 0 0 0 0 0 0 0 1 1 1 3 3 3 1 0 0 5
5 1 1 1 1 1 0 0 0 1 1 1 1 1 1 1 1 1 1 1 1 1 1 1 1 1 1 1 1 1 1 1 1 1 1 1 1 1 1 0 0 1 1 1 3 3 3 1 0 0 5
5 1 1 1 1 1 0 0 0 0 0 0 0 0 0 0 0 0 0 0 0 0 0 0 0 0 0 1 1 1 1 1 1 1 1 1 1 1 1 0 0 1 1 1 3 3 3 1 0 0 5
5 1 1 1 1 1 0 0 0 0 0 0 0 0 0 0 0 0 0 0 0 0 0 0 0 0 0 1 1 1 1 1 1 1 1 1 1 1 1 0 0 1 1 1 3 3 3 1 0 0 5
5 1 1 1 1 1 1 0 0 0 0 0 0 0 0 0 0 0 0 0 0 0 0 0 0 0 0 1 1 1 1 1 1 1 1 1 1 1 1 0 0 1 1 1 3 3 3 1 0 0 5
5 1 1 1 1 1 1 1 1 1 1 1 1 1 1 1 1 1 1 1 1 1 1 1 1 0 0 1 1 1 1 1 1 1 1 1 1 1 1 0 0 1 1 1 3 3 3 1 0 0 5
5 1 1 1 1 1 1 1 1 1 1 1 1 1 1 1 1 1 1 1 1 1 1 1 1 0 0 1 1 0 1 1 1 1 1 1 1 1 1 0 0 1 1 1 3 3 3 1 0 0 5
5 1 1 1 1 1 1 1 1 1 1 1 1 1 1 1 1 1 1 1 1 1 1 1 1 0 0 0 0 0 0 0 0 0 0 0 1 1 1 0 0 1 1 1 3 3 3 1 0 0 5
5 1 1 1 1 0 0 0 0 0 0 0 0 0 0 0 0 0 0 0 0 0 0 0 0 0 0 0 0 0 0 0 0 0 0 0 1 1 1 0 0 1 1 1 3 3 3 1 0 0 5
5 1 1 1 1 0 1 1 1 1 1 1 1 1 1 1 1 1 1 1 1 1 1 1 1 1 1 1 1 1 1 1 1 1 0 0 1 1 1 0 0 1 1 1 3 3 3 1 0 0 5
5 1 1 1 1 0 1 1 1 1 1 1 1 1 1 1 1 1 1 1 1 1 0 1 1 1 1 1 1 1 1 1 1 1 0 0 0 0 0 0 0 1 1 1 3 3 3 1 0 0 5
5 1 0 0 0 0 1 1 1 1 0 1 1 1 1 1 1 1 1 1 1 1 0 1 1 1 1 1 1 1 1 1 1 1 0 0 0 0 0 0 0 1 1 1 3 3 3 1 0 0 5
5 1 1 1 1 0 1 1 1 1 0 0 0 1 1 1 1 0 1 1 1 1 0 1 1 1 1 1 1 1 1 1 1 1 0 0 1 1 1 1 1 1 1 3 3 3 1 1 1 1 5
5 1 1 1 1 0 0 0 1 0 1 1 0 1 1 1 1 0 1 1 1 1 0 1 1 1 1 1 1 1 1 1 1 1 0 0 1 1 1 1 1 1 3 3 3 6 6 6 6 6 5
5 1 1 1 1 0 1 1 1 0 1 1 0 0 0 1 1 0 0 0 0 0 0 1 1 1 1 1 1 1 1 1 1 1 0 0 1 1 1 1 1 3 3 3 0 6 2 2 2 6 5
5 1 1 1 1 0 0 0 0 0 1 1 0 1 1 1 1 0 1 0 1 1 1 1 1 1 1 1 1 1 1 1 1 1 0 0 1 1 1 1 3 3 3 1 0 6 2 2 2 6 5
5 1 1 1 1 0 1 1 1 1 1 1 0 1 1 1 1 0 1 0 1 1 1 1 1 1 1 1 1 1 1 1 1 0 0 0 1 1 3 3 3 3 0 0 1 6 2 2 2 6 5
5 1 0 0 0 0 1 1 1 1 1 1 0 0 0 0 0 0 1 0 0 0 0 0 1 1 1 1 1 1 1 1 1 0 0 4 4 4 3 3 3 0 1 0 0 6 6 2 6 6 5
5 1 0 1 1 0 1 1 0 1 1 1 1 0 1 1 0 1 1 1 1 1 1 0 1 1 1 1 1 1 1 1 1 0 4 4 4 4 4 0 1 6 6 6 0 1 0 2 1 0 5
5 1 0 1 1 0 1 1 0 1 1 1 1 0 1 1 0 1 1 1 1 1 1 0 1 1 1 1 1 1 1 1 1 0 4 4 4 4 4 1 0 6 2 2 2 2 2 2 1 1 5
5 1 0 1 1 0 1 1 0 0 0 0 1 1 1 1 0 1 1 1 1 1 1 0 1 1 1 1 1 1 1 1 1 0 3 4 4 4 0 0 0 6 6 6 0 2 0 0 0 0 5
5 1 0 1 1 0 0 0 0 1 1 0 1 1 1 1 1 1 1 0 0 0 0 0 1 1 1 1 1 1 1 1 1 3 3 3 1 0 0 2 2 2 2 2 2 2 0 0 1 0 5
5 1 0 1 1 1 1 1 1 1 1 1 1 1 1 1 1 1 1 0 1 0 1 1 1 1 1 1 1 1 1 1 3 3 3 0 0 1 0 2 0 1 1 0 1 1 0 1 0 0 5
5 1 0 0 0 0 1 1 0 1 1 1 1 0 0 0 0 0 0 0 1 0 1 1 1 1 1 1 1 1 1 3 3 3 1 0 1 0 0 2 1 0 1 1 0 1 1 0 1 0 5
5 1 0 1 1 0 1 1 0 1 1 1 1 1 1 1 0 1 1 1 1 0 1 1 1 1 1 1 1 1 3 3 3 0 0 1 0 0 6 2 6 1 1 0 1 0 0 0 1 0 5
5 1 0 1 1 0 0 0 0 0 0 1 1 1 1 1 0 0 0 1 5 2 5 5 5 5 1 1 1 3 3 3 1 0 0 1 0 1 6 2 6 0 1 1 0 0 0 1 1 0 5
5 1 0 1 1 1 1 1 1 1 1 1 1 1 1 1 0 1 1 1 5 2 2 2 2 5 1 1 3 3 3 0 0 0 0 0 0 0 6 6 6 1 0 0 0 1 0 0 1 0 5
5 1 0 0 0 0 0 0 0 0 0 0 0 0 0 0 0 1 1 1 5 2 2 2 2 5 1 3 3 3 0 0 0 1 0 1 0 0 1 1 0 0 0 1 0 0 0 0 1 0 5
5 1 1 1 1 1 1 1 1 1 1 1 1 1 1 1 1 1 1 1 5 2 2 2 2 5 1 3 3 3 0 0 1 0 0 0 0 0 0 1 0 0 1 0 0 1 0 0 1 0 5
5 1 1 1 1 1 1 1 1 1 1 1 1 1 1 1 1 1 1 1 5 2 2 2 2 5 1 3 3 3 1 0 0 0 1 1 0 0 1 0 0 0 0 1 0 1 0 0 1 0 5
5 5 5 5 5 5 5 5 5 5 5 5 5 5 5 5 5 5 5 5 5 5 5 5 5 5 5 5 5 5 5 5 5 5 5 5 5 5 5 5 5 5 5 5 5 5 5 5 5 5 5